........ttt.......
..hthtttt.....h...
...htt.t....t.h...
....tt.h....tbtt..
..b.tt...tb...t...
..h..t....h..tt...
hh.b.th.tt...tb.h.
.ttb...tt....tt.h.
.ttb........h.t...
..thb.t.....ttt...
....b..tthttt...t.
.......bttt.......